11111111
100000E1
10P0C001
11111111