11111111
11C1EC11
1PC0C111
11111111