1111111111111111111111
11C1EC0000000000000001
1PC0C01111111110000001
1111111111111111111111